0,0,0,0,0,0,0,0,0
0,0,0,0,0,0,0,0,0
0,0,0,0,0,0,0,0,4
0,0,0,0,0,0,0,4,0
1,1,2,2,2,2,4,1,1
1,1,1,1,1,4,1,1,1
