0,0,0,0,0,0,0,0,0,0,6
0,0,0,0,0,0,0,0,0,0,6
6,0,0,0,0,0,0,0,0,0,6
6,0,1,2,2,2,5,5,5,0,6
6,0,1,1,1,1,4,1,1,0,6
6,0,0,0,0,0,0,0,0,0,6
6,6,6,6,6,6,6,6,6,6,6
